Architecture: CDNA2
Instruction: V_MFMA_F32_32X32X2F32
Block 0
+-----------+--------+--------+
|   A[M][K] | 0      | 1      |
+===========+========+========+
|         0 | v0{0}  | v0{32} |
+-----------+--------+--------+
|         1 | v0{1}  | v0{33} |
+-----------+--------+--------+
|         2 | v0{2}  | v0{34} |
+-----------+--------+--------+
|         3 | v0{3}  | v0{35} |
+-----------+--------+--------+
|         4 | v0{4}  | v0{36} |
+-----------+--------+--------+
|         5 | v0{5}  | v0{37} |
+-----------+--------+--------+
|         6 | v0{6}  | v0{38} |
+-----------+--------+--------+
|         7 | v0{7}  | v0{39} |
+-----------+--------+--------+
|         8 | v0{8}  | v0{40} |
+-----------+--------+--------+
|         9 | v0{9}  | v0{41} |
+-----------+--------+--------+
|        10 | v0{10} | v0{42} |
+-----------+--------+--------+
|        11 | v0{11} | v0{43} |
+-----------+--------+--------+
|        12 | v0{12} | v0{44} |
+-----------+--------+--------+
|        13 | v0{13} | v0{45} |
+-----------+--------+--------+
|        14 | v0{14} | v0{46} |
+-----------+--------+--------+
|        15 | v0{15} | v0{47} |
+-----------+--------+--------+
|        16 | v0{16} | v0{48} |
+-----------+--------+--------+
|        17 | v0{17} | v0{49} |
+-----------+--------+--------+
|        18 | v0{18} | v0{50} |
+-----------+--------+--------+
|        19 | v0{19} | v0{51} |
+-----------+--------+--------+
|        20 | v0{20} | v0{52} |
+-----------+--------+--------+
|        21 | v0{21} | v0{53} |
+-----------+--------+--------+
|        22 | v0{22} | v0{54} |
+-----------+--------+--------+
|        23 | v0{23} | v0{55} |
+-----------+--------+--------+
|        24 | v0{24} | v0{56} |
+-----------+--------+--------+
|        25 | v0{25} | v0{57} |
+-----------+--------+--------+
|        26 | v0{26} | v0{58} |
+-----------+--------+--------+
|        27 | v0{27} | v0{59} |
+-----------+--------+--------+
|        28 | v0{28} | v0{60} |
+-----------+--------+--------+
|        29 | v0{29} | v0{61} |
+-----------+--------+--------+
|        30 | v0{30} | v0{62} |
+-----------+--------+--------+
|        31 | v0{31} | v0{63} |
+-----------+--------+--------+
