Architecture: CDNA2
Instruction: V_MFMA_F32_32X32X2F32
Block 0
+-----------+---------+---------+---------+---------+---------+---------+---------+---------+---------+---------+---------+---------+---------+---------+---------+---------+---------+---------+---------+---------+---------+---------+---------+---------+---------+---------+---------+---------+---------+---------+---------+---------+
|   C[M][N] | 0       | 1       | 2       | 3       | 4       | 5       | 6       | 7       | 8       | 9       | 10      | 11      | 12      | 13      | 14      | 15      | 16      | 17      | 18      | 19      | 20      | 21      | 22      | 23      | 24      | 25      | 26      | 27      | 28      | 29      | 30      | 31      |
+===========+=========+=========+=========+=========+=========+=========+=========+=========+=========+=========+=========+=========+=========+=========+=========+=========+=========+=========+=========+=========+=========+=========+=========+=========+=========+=========+=========+=========+=========+=========+=========+=========+
|         0 | v0{0}   | v0{1}   | v0{2}   | v0{3}   | v0{4}   | v0{5}   | v0{6}   | v0{7}   | v0{8}   | v0{9}   | v0{10}  | v0{11}  | v0{12}  | v0{13}  | v0{14}  | v0{15}  | v0{16}  | v0{17}  | v0{18}  | v0{19}  | v0{20}  | v0{21}  | v0{22}  | v0{23}  | v0{24}  | v0{25}  | v0{26}  | v0{27}  | v0{28}  | v0{29}  | v0{30}  | v0{31}  |
+-----------+---------+---------+---------+---------+---------+---------+---------+---------+---------+---------+---------+---------+---------+---------+---------+---------+---------+---------+---------+---------+---------+---------+---------+---------+---------+---------+---------+---------+---------+---------+---------+---------+
|         1 | v1{0}   | v1{1}   | v1{2}   | v1{3}   | v1{4}   | v1{5}   | v1{6}   | v1{7}   | v1{8}   | v1{9}   | v1{10}  | v1{11}  | v1{12}  | v1{13}  | v1{14}  | v1{15}  | v1{16}  | v1{17}  | v1{18}  | v1{19}  | v1{20}  | v1{21}  | v1{22}  | v1{23}  | v1{24}  | v1{25}  | v1{26}  | v1{27}  | v1{28}  | v1{29}  | v1{30}  | v1{31}  |
+-----------+---------+---------+---------+---------+---------+---------+---------+---------+---------+---------+---------+---------+---------+---------+---------+---------+---------+---------+---------+---------+---------+---------+---------+---------+---------+---------+---------+---------+---------+---------+---------+---------+
|         2 | v2{0}   | v2{1}   | v2{2}   | v2{3}   | v2{4}   | v2{5}   | v2{6}   | v2{7}   | v2{8}   | v2{9}   | v2{10}  | v2{11}  | v2{12}  | v2{13}  | v2{14}  | v2{15}  | v2{16}  | v2{17}  | v2{18}  | v2{19}  | v2{20}  | v2{21}  | v2{22}  | v2{23}  | v2{24}  | v2{25}  | v2{26}  | v2{27}  | v2{28}  | v2{29}  | v2{30}  | v2{31}  |
+-----------+---------+---------+---------+---------+---------+---------+---------+---------+---------+---------+---------+---------+---------+---------+---------+---------+---------+---------+---------+---------+---------+---------+---------+---------+---------+---------+---------+---------+---------+---------+---------+---------+
|         3 | v3{0}   | v3{1}   | v3{2}   | v3{3}   | v3{4}   | v3{5}   | v3{6}   | v3{7}   | v3{8}   | v3{9}   | v3{10}  | v3{11}  | v3{12}  | v3{13}  | v3{14}  | v3{15}  | v3{16}  | v3{17}  | v3{18}  | v3{19}  | v3{20}  | v3{21}  | v3{22}  | v3{23}  | v3{24}  | v3{25}  | v3{26}  | v3{27}  | v3{28}  | v3{29}  | v3{30}  | v3{31}  |
+-----------+---------+---------+---------+---------+---------+---------+---------+---------+---------+---------+---------+---------+---------+---------+---------+---------+---------+---------+---------+---------+---------+---------+---------+---------+---------+---------+---------+---------+---------+---------+---------+---------+
|         4 | v0{32}  | v0{33}  | v0{34}  | v0{35}  | v0{36}  | v0{37}  | v0{38}  | v0{39}  | v0{40}  | v0{41}  | v0{42}  | v0{43}  | v0{44}  | v0{45}  | v0{46}  | v0{47}  | v0{48}  | v0{49}  | v0{50}  | v0{51}  | v0{52}  | v0{53}  | v0{54}  | v0{55}  | v0{56}  | v0{57}  | v0{58}  | v0{59}  | v0{60}  | v0{61}  | v0{62}  | v0{63}  |
+-----------+---------+---------+---------+---------+---------+---------+---------+---------+---------+---------+---------+---------+---------+---------+---------+---------+---------+---------+---------+---------+---------+---------+---------+---------+---------+---------+---------+---------+---------+---------+---------+---------+
|         5 | v1{32}  | v1{33}  | v1{34}  | v1{35}  | v1{36}  | v1{37}  | v1{38}  | v1{39}  | v1{40}  | v1{41}  | v1{42}  | v1{43}  | v1{44}  | v1{45}  | v1{46}  | v1{47}  | v1{48}  | v1{49}  | v1{50}  | v1{51}  | v1{52}  | v1{53}  | v1{54}  | v1{55}  | v1{56}  | v1{57}  | v1{58}  | v1{59}  | v1{60}  | v1{61}  | v1{62}  | v1{63}  |
+-----------+---------+---------+---------+---------+---------+---------+---------+---------+---------+---------+---------+---------+---------+---------+---------+---------+---------+---------+---------+---------+---------+---------+---------+---------+---------+---------+---------+---------+---------+---------+---------+---------+
|         6 | v2{32}  | v2{33}  | v2{34}  | v2{35}  | v2{36}  | v2{37}  | v2{38}  | v2{39}  | v2{40}  | v2{41}  | v2{42}  | v2{43}  | v2{44}  | v2{45}  | v2{46}  | v2{47}  | v2{48}  | v2{49}  | v2{50}  | v2{51}  | v2{52}  | v2{53}  | v2{54}  | v2{55}  | v2{56}  | v2{57}  | v2{58}  | v2{59}  | v2{60}  | v2{61}  | v2{62}  | v2{63}  |
+-----------+---------+---------+---------+---------+---------+---------+---------+---------+---------+---------+---------+---------+---------+---------+---------+---------+---------+---------+---------+---------+---------+---------+---------+---------+---------+---------+---------+---------+---------+---------+---------+---------+
|         7 | v3{32}  | v3{33}  | v3{34}  | v3{35}  | v3{36}  | v3{37}  | v3{38}  | v3{39}  | v3{40}  | v3{41}  | v3{42}  | v3{43}  | v3{44}  | v3{45}  | v3{46}  | v3{47}  | v3{48}  | v3{49}  | v3{50}  | v3{51}  | v3{52}  | v3{53}  | v3{54}  | v3{55}  | v3{56}  | v3{57}  | v3{58}  | v3{59}  | v3{60}  | v3{61}  | v3{62}  | v3{63}  |
+-----------+---------+---------+---------+---------+---------+---------+---------+---------+---------+---------+---------+---------+---------+---------+---------+---------+---------+---------+---------+---------+---------+---------+---------+---------+---------+---------+---------+---------+---------+---------+---------+---------+
|         8 | v4{0}   | v4{1}   | v4{2}   | v4{3}   | v4{4}   | v4{5}   | v4{6}   | v4{7}   | v4{8}   | v4{9}   | v4{10}  | v4{11}  | v4{12}  | v4{13}  | v4{14}  | v4{15}  | v4{16}  | v4{17}  | v4{18}  | v4{19}  | v4{20}  | v4{21}  | v4{22}  | v4{23}  | v4{24}  | v4{25}  | v4{26}  | v4{27}  | v4{28}  | v4{29}  | v4{30}  | v4{31}  |
+-----------+---------+---------+---------+---------+---------+---------+---------+---------+---------+---------+---------+---------+---------+---------+---------+---------+---------+---------+---------+---------+---------+---------+---------+---------+---------+---------+---------+---------+---------+---------+---------+---------+
|         9 | v5{0}   | v5{1}   | v5{2}   | v5{3}   | v5{4}   | v5{5}   | v5{6}   | v5{7}   | v5{8}   | v5{9}   | v5{10}  | v5{11}  | v5{12}  | v5{13}  | v5{14}  | v5{15}  | v5{16}  | v5{17}  | v5{18}  | v5{19}  | v5{20}  | v5{21}  | v5{22}  | v5{23}  | v5{24}  | v5{25}  | v5{26}  | v5{27}  | v5{28}  | v5{29}  | v5{30}  | v5{31}  |
+-----------+---------+---------+---------+---------+---------+---------+---------+---------+---------+---------+---------+---------+---------+---------+---------+---------+---------+---------+---------+---------+---------+---------+---------+---------+---------+---------+---------+---------+---------+---------+---------+---------+
|        10 | v6{0}   | v6{1}   | v6{2}   | v6{3}   | v6{4}   | v6{5}   | v6{6}   | v6{7}   | v6{8}   | v6{9}   | v6{10}  | v6{11}  | v6{12}  | v6{13}  | v6{14}  | v6{15}  | v6{16}  | v6{17}  | v6{18}  | v6{19}  | v6{20}  | v6{21}  | v6{22}  | v6{23}  | v6{24}  | v6{25}  | v6{26}  | v6{27}  | v6{28}  | v6{29}  | v6{30}  | v6{31}  |
+-----------+---------+---------+---------+---------+---------+---------+---------+---------+---------+---------+---------+---------+---------+---------+---------+---------+---------+---------+---------+---------+---------+---------+---------+---------+---------+---------+---------+---------+---------+---------+---------+---------+
|        11 | v7{0}   | v7{1}   | v7{2}   | v7{3}   | v7{4}   | v7{5}   | v7{6}   | v7{7}   | v7{8}   | v7{9}   | v7{10}  | v7{11}  | v7{12}  | v7{13}  | v7{14}  | v7{15}  | v7{16}  | v7{17}  | v7{18}  | v7{19}  | v7{20}  | v7{21}  | v7{22}  | v7{23}  | v7{24}  | v7{25}  | v7{26}  | v7{27}  | v7{28}  | v7{29}  | v7{30}  | v7{31}  |
+-----------+---------+---------+---------+---------+---------+---------+---------+---------+---------+---------+---------+---------+---------+---------+---------+---------+---------+---------+---------+---------+---------+---------+---------+---------+---------+---------+---------+---------+---------+---------+---------+---------+
|        12 | v4{32}  | v4{33}  | v4{34}  | v4{35}  | v4{36}  | v4{37}  | v4{38}  | v4{39}  | v4{40}  | v4{41}  | v4{42}  | v4{43}  | v4{44}  | v4{45}  | v4{46}  | v4{47}  | v4{48}  | v4{49}  | v4{50}  | v4{51}  | v4{52}  | v4{53}  | v4{54}  | v4{55}  | v4{56}  | v4{57}  | v4{58}  | v4{59}  | v4{60}  | v4{61}  | v4{62}  | v4{63}  |
+-----------+---------+---------+---------+---------+---------+---------+---------+---------+---------+---------+---------+---------+---------+---------+---------+---------+---------+---------+---------+---------+---------+---------+---------+---------+---------+---------+---------+---------+---------+---------+---------+---------+
|        13 | v5{32}  | v5{33}  | v5{34}  | v5{35}  | v5{36}  | v5{37}  | v5{38}  | v5{39}  | v5{40}  | v5{41}  | v5{42}  | v5{43}  | v5{44}  | v5{45}  | v5{46}  | v5{47}  | v5{48}  | v5{49}  | v5{50}  | v5{51}  | v5{52}  | v5{53}  | v5{54}  | v5{55}  | v5{56}  | v5{57}  | v5{58}  | v5{59}  | v5{60}  | v5{61}  | v5{62}  | v5{63}  |
+-----------+---------+---------+---------+---------+---------+---------+---------+---------+---------+---------+---------+---------+---------+---------+---------+---------+---------+---------+---------+---------+---------+---------+---------+---------+---------+---------+---------+---------+---------+---------+---------+---------+
|        14 | v6{32}  | v6{33}  | v6{34}  | v6{35}  | v6{36}  | v6{37}  | v6{38}  | v6{39}  | v6{40}  | v6{41}  | v6{42}  | v6{43}  | v6{44}  | v6{45}  | v6{46}  | v6{47}  | v6{48}  | v6{49}  | v6{50}  | v6{51}  | v6{52}  | v6{53}  | v6{54}  | v6{55}  | v6{56}  | v6{57}  | v6{58}  | v6{59}  | v6{60}  | v6{61}  | v6{62}  | v6{63}  |
+-----------+---------+---------+---------+---------+---------+---------+---------+---------+---------+---------+---------+---------+---------+---------+---------+---------+---------+---------+---------+---------+---------+---------+---------+---------+---------+---------+---------+---------+---------+---------+---------+---------+
|        15 | v7{32}  | v7{33}  | v7{34}  | v7{35}  | v7{36}  | v7{37}  | v7{38}  | v7{39}  | v7{40}  | v7{41}  | v7{42}  | v7{43}  | v7{44}  | v7{45}  | v7{46}  | v7{47}  | v7{48}  | v7{49}  | v7{50}  | v7{51}  | v7{52}  | v7{53}  | v7{54}  | v7{55}  | v7{56}  | v7{57}  | v7{58}  | v7{59}  | v7{60}  | v7{61}  | v7{62}  | v7{63}  |
+-----------+---------+---------+---------+---------+---------+---------+---------+---------+---------+---------+---------+---------+---------+---------+---------+---------+---------+---------+---------+---------+---------+---------+---------+---------+---------+---------+---------+---------+---------+---------+---------+---------+
|        16 | v8{0}   | v8{1}   | v8{2}   | v8{3}   | v8{4}   | v8{5}   | v8{6}   | v8{7}   | v8{8}   | v8{9}   | v8{10}  | v8{11}  | v8{12}  | v8{13}  | v8{14}  | v8{15}  | v8{16}  | v8{17}  | v8{18}  | v8{19}  | v8{20}  | v8{21}  | v8{22}  | v8{23}  | v8{24}  | v8{25}  | v8{26}  | v8{27}  | v8{28}  | v8{29}  | v8{30}  | v8{31}  |
+-----------+---------+---------+---------+---------+---------+---------+---------+---------+---------+---------+---------+---------+---------+---------+---------+---------+---------+---------+---------+---------+---------+---------+---------+---------+---------+---------+---------+---------+---------+---------+---------+---------+
|        17 | v9{0}   | v9{1}   | v9{2}   | v9{3}   | v9{4}   | v9{5}   | v9{6}   | v9{7}   | v9{8}   | v9{9}   | v9{10}  | v9{11}  | v9{12}  | v9{13}  | v9{14}  | v9{15}  | v9{16}  | v9{17}  | v9{18}  | v9{19}  | v9{20}  | v9{21}  | v9{22}  | v9{23}  | v9{24}  | v9{25}  | v9{26}  | v9{27}  | v9{28}  | v9{29}  | v9{30}  | v9{31}  |
+-----------+---------+---------+---------+---------+---------+---------+---------+---------+---------+---------+---------+---------+---------+---------+---------+---------+---------+---------+---------+---------+---------+---------+---------+---------+---------+---------+---------+---------+---------+---------+---------+---------+
|        18 | v10{0}  | v10{1}  | v10{2}  | v10{3}  | v10{4}  | v10{5}  | v10{6}  | v10{7}  | v10{8}  | v10{9}  | v10{10} | v10{11} | v10{12} | v10{13} | v10{14} | v10{15} | v10{16} | v10{17} | v10{18} | v10{19} | v10{20} | v10{21} | v10{22} | v10{23} | v10{24} | v10{25} | v10{26} | v10{27} | v10{28} | v10{29} | v10{30} | v10{31} |
+-----------+---------+---------+---------+---------+---------+---------+---------+---------+---------+---------+---------+---------+---------+---------+---------+---------+---------+---------+---------+---------+---------+---------+---------+---------+---------+---------+---------+---------+---------+---------+---------+---------+
|        19 | v11{0}  | v11{1}  | v11{2}  | v11{3}  | v11{4}  | v11{5}  | v11{6}  | v11{7}  | v11{8}  | v11{9}  | v11{10} | v11{11} | v11{12} | v11{13} | v11{14} | v11{15} | v11{16} | v11{17} | v11{18} | v11{19} | v11{20} | v11{21} | v11{22} | v11{23} | v11{24} | v11{25} | v11{26} | v11{27} | v11{28} | v11{29} | v11{30} | v11{31} |
+-----------+---------+---------+---------+---------+---------+---------+---------+---------+---------+---------+---------+---------+---------+---------+---------+---------+---------+---------+---------+---------+---------+---------+---------+---------+---------+---------+---------+---------+---------+---------+---------+---------+
|        20 | v8{32}  | v8{33}  | v8{34}  | v8{35}  | v8{36}  | v8{37}  | v8{38}  | v8{39}  | v8{40}  | v8{41}  | v8{42}  | v8{43}  | v8{44}  | v8{45}  | v8{46}  | v8{47}  | v8{48}  | v8{49}  | v8{50}  | v8{51}  | v8{52}  | v8{53}  | v8{54}  | v8{55}  | v8{56}  | v8{57}  | v8{58}  | v8{59}  | v8{60}  | v8{61}  | v8{62}  | v8{63}  |
+-----------+---------+---------+---------+---------+---------+---------+---------+---------+---------+---------+---------+---------+---------+---------+---------+---------+---------+---------+---------+---------+---------+---------+---------+---------+---------+---------+---------+---------+---------+---------+---------+---------+
|        21 | v9{32}  | v9{33}  | v9{34}  | v9{35}  | v9{36}  | v9{37}  | v9{38}  | v9{39}  | v9{40}  | v9{41}  | v9{42}  | v9{43}  | v9{44}  | v9{45}  | v9{46}  | v9{47}  | v9{48}  | v9{49}  | v9{50}  | v9{51}  | v9{52}  | v9{53}  | v9{54}  | v9{55}  | v9{56}  | v9{57}  | v9{58}  | v9{59}  | v9{60}  | v9{61}  | v9{62}  | v9{63}  |
+-----------+---------+---------+---------+---------+---------+---------+---------+---------+---------+---------+---------+---------+---------+---------+---------+---------+---------+---------+---------+---------+---------+---------+---------+---------+---------+---------+---------+---------+---------+---------+---------+---------+
|        22 | v10{32} | v10{33} | v10{34} | v10{35} | v10{36} | v10{37} | v10{38} | v10{39} | v10{40} | v10{41} | v10{42} | v10{43} | v10{44} | v10{45} | v10{46} | v10{47} | v10{48} | v10{49} | v10{50} | v10{51} | v10{52} | v10{53} | v10{54} | v10{55} | v10{56} | v10{57} | v10{58} | v10{59} | v10{60} | v10{61} | v10{62} | v10{63} |
+-----------+---------+---------+---------+---------+---------+---------+---------+---------+---------+---------+---------+---------+---------+---------+---------+---------+---------+---------+---------+---------+---------+---------+---------+---------+---------+---------+---------+---------+---------+---------+---------+---------+
|        23 | v11{32} | v11{33} | v11{34} | v11{35} | v11{36} | v11{37} | v11{38} | v11{39} | v11{40} | v11{41} | v11{42} | v11{43} | v11{44} | v11{45} | v11{46} | v11{47} | v11{48} | v11{49} | v11{50} | v11{51} | v11{52} | v11{53} | v11{54} | v11{55} | v11{56} | v11{57} | v11{58} | v11{59} | v11{60} | v11{61} | v11{62} | v11{63} |
+-----------+---------+---------+---------+---------+---------+---------+---------+---------+---------+---------+---------+---------+---------+---------+---------+---------+---------+---------+---------+---------+---------+---------+---------+---------+---------+---------+---------+---------+---------+---------+---------+---------+
|        24 | v12{0}  | v12{1}  | v12{2}  | v12{3}  | v12{4}  | v12{5}  | v12{6}  | v12{7}  | v12{8}  | v12{9}  | v12{10} | v12{11} | v12{12} | v12{13} | v12{14} | v12{15} | v12{16} | v12{17} | v12{18} | v12{19} | v12{20} | v12{21} | v12{22} | v12{23} | v12{24} | v12{25} | v12{26} | v12{27} | v12{28} | v12{29} | v12{30} | v12{31} |
+-----------+---------+---------+---------+---------+---------+---------+---------+---------+---------+---------+---------+---------+---------+---------+---------+---------+---------+---------+---------+---------+---------+---------+---------+---------+---------+---------+---------+---------+---------+---------+---------+---------+
|        25 | v13{0}  | v13{1}  | v13{2}  | v13{3}  | v13{4}  | v13{5}  | v13{6}  | v13{7}  | v13{8}  | v13{9}  | v13{10} | v13{11} | v13{12} | v13{13} | v13{14} | v13{15} | v13{16} | v13{17} | v13{18} | v13{19} | v13{20} | v13{21} | v13{22} | v13{23} | v13{24} | v13{25} | v13{26} | v13{27} | v13{28} | v13{29} | v13{30} | v13{31} |
+-----------+---------+---------+---------+---------+---------+---------+---------+---------+---------+---------+---------+---------+---------+---------+---------+---------+---------+---------+---------+---------+---------+---------+---------+---------+---------+---------+---------+---------+---------+---------+---------+---------+
|        26 | v14{0}  | v14{1}  | v14{2}  | v14{3}  | v14{4}  | v14{5}  | v14{6}  | v14{7}  | v14{8}  | v14{9}  | v14{10} | v14{11} | v14{12} | v14{13} | v14{14} | v14{15} | v14{16} | v14{17} | v14{18} | v14{19} | v14{20} | v14{21} | v14{22} | v14{23} | v14{24} | v14{25} | v14{26} | v14{27} | v14{28} | v14{29} | v14{30} | v14{31} |
+-----------+---------+---------+---------+---------+---------+---------+---------+---------+---------+---------+---------+---------+---------+---------+---------+---------+---------+---------+---------+---------+---------+---------+---------+---------+---------+---------+---------+---------+---------+---------+---------+---------+
|        27 | v15{0}  | v15{1}  | v15{2}  | v15{3}  | v15{4}  | v15{5}  | v15{6}  | v15{7}  | v15{8}  | v15{9}  | v15{10} | v15{11} | v15{12} | v15{13} | v15{14} | v15{15} | v15{16} | v15{17} | v15{18} | v15{19} | v15{20} | v15{21} | v15{22} | v15{23} | v15{24} | v15{25} | v15{26} | v15{27} | v15{28} | v15{29} | v15{30} | v15{31} |
+-----------+---------+---------+---------+---------+---------+---------+---------+---------+---------+---------+---------+---------+---------+---------+---------+---------+---------+---------+---------+---------+---------+---------+---------+---------+---------+---------+---------+---------+---------+---------+---------+---------+
|        28 | v12{32} | v12{33} | v12{34} | v12{35} | v12{36} | v12{37} | v12{38} | v12{39} | v12{40} | v12{41} | v12{42} | v12{43} | v12{44} | v12{45} | v12{46} | v12{47} | v12{48} | v12{49} | v12{50} | v12{51} | v12{52} | v12{53} | v12{54} | v12{55} | v12{56} | v12{57} | v12{58} | v12{59} | v12{60} | v12{61} | v12{62} | v12{63} |
+-----------+---------+---------+---------+---------+---------+---------+---------+---------+---------+---------+---------+---------+---------+---------+---------+---------+---------+---------+---------+---------+---------+---------+---------+---------+---------+---------+---------+---------+---------+---------+---------+---------+
|        29 | v13{32} | v13{33} | v13{34} | v13{35} | v13{36} | v13{37} | v13{38} | v13{39} | v13{40} | v13{41} | v13{42} | v13{43} | v13{44} | v13{45} | v13{46} | v13{47} | v13{48} | v13{49} | v13{50} | v13{51} | v13{52} | v13{53} | v13{54} | v13{55} | v13{56} | v13{57} | v13{58} | v13{59} | v13{60} | v13{61} | v13{62} | v13{63} |
+-----------+---------+---------+---------+---------+---------+---------+---------+---------+---------+---------+---------+---------+---------+---------+---------+---------+---------+---------+---------+---------+---------+---------+---------+---------+---------+---------+---------+---------+---------+---------+---------+---------+
|        30 | v14{32} | v14{33} | v14{34} | v14{35} | v14{36} | v14{37} | v14{38} | v14{39} | v14{40} | v14{41} | v14{42} | v14{43} | v14{44} | v14{45} | v14{46} | v14{47} | v14{48} | v14{49} | v14{50} | v14{51} | v14{52} | v14{53} | v14{54} | v14{55} | v14{56} | v14{57} | v14{58} | v14{59} | v14{60} | v14{61} | v14{62} | v14{63} |
+-----------+---------+---------+---------+---------+---------+---------+---------+---------+---------+---------+---------+---------+---------+---------+---------+---------+---------+---------+---------+---------+---------+---------+---------+---------+---------+---------+---------+---------+---------+---------+---------+---------+
|        31 | v15{32} | v15{33} | v15{34} | v15{35} | v15{36} | v15{37} | v15{38} | v15{39} | v15{40} | v15{41} | v15{42} | v15{43} | v15{44} | v15{45} | v15{46} | v15{47} | v15{48} | v15{49} | v15{50} | v15{51} | v15{52} | v15{53} | v15{54} | v15{55} | v15{56} | v15{57} | v15{58} | v15{59} | v15{60} | v15{61} | v15{62} | v15{63} |
+-----------+---------+---------+---------+---------+---------+---------+---------+---------+---------+---------+---------+---------+---------+---------+---------+---------+---------+---------+---------+---------+---------+---------+---------+---------+---------+---------+---------+---------+---------+---------+---------+---------+
